3 2 2 2 2 2 -2 -2 -2 -2 2 2 2 2 2 4
7 1 1 1 1 1 -1 -1 -1 -1 1 1 1 1 1 8
7 0 0 0 0 0 0 0 0 0 0 0 0 0 0 8
7 0 0 0 0 0 0 0 0 0 0 0 0 0 0 8
0 0 0 0 0 0 0 0 0 0 0 0 0 0 0 0
7 0 0 0 0 0 0 0 0 0 0 0 0 0 0 8
7 0 0 0 0 0 0 0 0 0 0 0 0 0 0 8
7 2 2 2 2 2 -2 -2 -2 -2 2 2 2 2 2 8
5 1 1 1 1 1 -1 -1 -1 -1 1 1 1 1 1 6