3 1 1 1 1 1 1 1 1 1 1 1 1 1 1 4
7 0 0 0 0 0 0 0 0 0 0 0 0 0 0 8
7 0 0 0 0 0 0 0 0 0 0 0 0 0 0 8
7 0 0 0 0 0 0 0 0 0 0 0 0 0 0 8
7 0 0 0 0 0 0 0 0 0 0 0 0 0 0 8
7 0 0 0 0 0 0 0 0 0 0 0 0 0 0 8
7 0 0 0 0 0 0 0 0 0 0 0 0 0 0 8
5 2 2 2 2 2 2 2 2 2 2 2 2 2 2 6
1 1 1 1 1 1 1 1 1 1 1 1 1 1 1 1